........................
....M.....____..........
........................
.___.......M.....___....
.........____...........
.H......................
________________________