.............................................
.......................M.....................
.............................................
.............M.................M.............
............____.............____............
.......................H.....................
.........___________________________.........