................................
.....M..........................
................................
........................M.......
................................
................................
................................
...............__...............
.......H........................
________________________________