...................................
........MM.........................
........MM...........______........
...................................
...................................
...........................H.......
___________________________________