......................................
....M.................................
...............................M......
......................................
..................H...................
...........______________.............
......................................
....M..............................M..
..______......................______..