...................................
....M...................M..........
..._______...........______........
...................................
....M........_____.................
...........................H.......
___________________________________