...................................
.............M.....................
...................................
......__________________...........
..M.............................M..
.___...........H...............___.
..........._________...............