...................................
____...........................M...
......M........._____..............
...................................
.....___.......................___.
..........M................H.......
___________________________________